11111111111111111111111111
10000000000010000000000001
10000000000010000000000001
10000000000011000000000001
10000000000001000000000001
10000000000001000000000001
10000000000001000000000001
10000000000011000000000001
10000000000010000000000001
10000000000010000000000001
10000000000011000000000001
11111111111111111111111111
end;