11111111111111111111111111
11110000000000000000111111
11110000000000000000111111
11110000000000000000111111
11110000000000000000111111
10010000000000000000111001
10010000000000000000111001
11110000000000000000111111
11110000000000000000111111
11110000000000000000111111
11110000000000000000111111
11111111111111111111111111
end;сгенерировать карту