11111111111111111111111111
10000000100000010000011001
10011111111111110110001001
10010000001000000011000001
10011111101001111110011001
10001001001001001000110001
10001001001001001111100001
11111001001000000000111111
10011000001111110100001001
10001100100000011100001001
10000000000000000000000001
11111111111111111111111111
end;