11111111111111111111111111
10010010000000100110000011
10111010000011111110000001
11000000101001001000010101
10000011100000100010001001
10010100101010000101000001
10001011000000100111000001
10101110001000010100010011
10100001000001000000010101
10100110000110110100010101
10110000010010100001001001
11111111111111111111111111
end;