11111111111111111111111111
10000000010000001000000001
10000000010000001000000001
10000000010011001000000001
10000000010011001000000001
10000000000011000000000001
10000000000011000000000001
10000000010011001000000001
10000000010011001000000001
10000000010000001000000001
10000000010000001000000001
11111111111111111111111111
end;сгенерировать карту