11111111111111111111111111
10000011000000000001100001
10000011000000000001100001
10000011000100010001100001
10000000000100010000000001
10000000000100010000000001
10000000000100010000000001
10000000000100010000000001
10000011000000000001100001
10000011000000000001100001
10000011000000000001100001
11111111111111111111111111
end;сгенерировать карту